This is going to be a challenge.	Isso será um desafio.
This is his answer to my letter.	Esta é a sua resposta à minha carta.
This is how I usually cook fish.	É assim que costumo preparar peixe.
This is mine, and this is yours.	Este é meu e esse é seu.
This is probably a real diamond.	Esse é provavelmente um diamante de verdade.
This is somebody else's problem.	Isto é problema de outra pessoa.
This is the best thing on earth.	Isso é a melhor coisa na terra.
This is the best thing on earth.	Essa é a melhor coisa na terra.
This is the book I want to read.	Este é o livro que eu quero ler.
This is the job Tom pays us for.	Este é o trabalho pelo qual o Tom nos paga.
This is the safest place I know.	Este é o lugar mais seguro que eu conheço.
This is the worst hotel in town.	Este é o pior hotel da cidade.
This looks like a gunshot wound.	Isto parece um ferimento a bala.
This machine is now out of date.	Esta máquina é agora obsoleta.
This medication works instantly.	Este remédio tem efeito imediato.
This one is as good as that one.	Este é tão bom quanto aquele.
This one is as good as that one.	Este é tão bom como aquele.
This one is as good as that one.	Esta é tão boa quanto aquela.
This one is as good as that one.	Esta é tão boa como aquela.
This picture was painted by Tom.	Este quadro foi pintado por Tom.
This place is open to everybody.	Esse lugar é aberto para todos.
This place is open to everybody.	Este lugar é aberto para todos.
This really doesn't concern you.	Isso não te interessa, mesmo.
This school was founded in 1650.	A escola foi fundada em 1650.
This school was founded in 1650.	Essa escola foi fundada em 1650.
This sentence contains an error.	Esta frase contém um erro.
This sentence is not in English.	Esta frase não está em inglês.
This should be more than enough.	Isso deveria ser mais que o suficiente.
This song reminds me of someone.	Essa música me lembra alguém.
This song was written by Foster.	Esta música foi escrita por Foster.
This song was written by Foster.	Esta canção foi escrita por Foster.
This stool needs to be repaired.	Esse banquinho precisa ser consertado.
This was not supposed to happen.	Não era para isso acontecer.
Those shoes don't belong to Tom.	Esses sapatos não pertencem ao Tom.
Those shoes don't belong to Tom.	Esses sapatos não são do Tom.
Those who want to stay can stay.	Aqueles que quiserem ficar podem ficar.
Three crew members were rescued.	Três membros da tripulação foram resgatados.
Time is the most precious thing.	O tempo é a coisa mais preciosa que existe.
Today is election day in Poland.	Hoje tem eleições na Polônia.
Today is our last day of school.	Hoje é nosso último dia de aula.
Today is our last day of school.	Hoje é o nosso último dia de aula.
Today, I have a lot of homework.	Hoje tenho muita lição de casa.
Today, the weather is very nice.	Hoje o tempo está muito bom.
Tom Jackson is our only suspect.	Tom Jackson é nosso único suspeito.
Tom accompanied me on the piano.	Tom me acompanhou no piano.
Tom admitted that he was afraid.	Tom admitiu que estava com medo.
Tom admitted that he was guilty.	Tom admitiu que era culpado.
Tom admitted that he was scared.	Tom admitiu que ele estava com medo.
Tom almost never eats breakfast.	Tom não toma café da manhã quase nunca.
Tom almost never makes mistakes.	Tom quase nunca comete erros.
Tom almost never uses his phone.	Tom quase nunca usa seu celular.
Tom already regrets what he did.	Tom já está arrependido do que fez.
Tom already regrets what he did.	O Tom já está arrependido do que fez.
Tom also speaks a little French.	O Tom também fala um pouco de francês.
Tom and I are childhood friends.	Eu e Tom somos amigos de infância.
Tom and I are going to be there.	Tom e eu vamos estar lá.
Tom and I are going to be there.	Tom e eu estaremos lá.
Tom and I are in the same class.	Tom e eu estamos na mesma sala.
Tom and I go to school together.	Tom e eu vamos à escola juntos.
Tom and I study French together.	Tom e eu estudamos francês juntos.
Tom and Mary almost got married.	Tom e Mary quase se casaram.
Tom and Mary are both Canadians.	Tanto Tom quanto Maria são canadenses.
Tom and Mary are deeply in love.	O Tom e a Mary estão muito apaixonados.
Tom and Mary are happy together.	Tom e Mary são felizes juntos.
Tom and Mary are happy together.	Tom e Mary estão felizes juntos.
Tom and Mary are in the library.	Tom e Maria estão na biblioteca.
Tom and Mary are no longer here.	Tom e Maria não estão mais aqui.
Tom and Mary are playing tennis.	Tom e Mary estão jogando tênis.
Tom and Mary are still together.	Tom e Maria ainda estão juntos.
Tom and Mary are working nearby.	Tom e Mary estão trabalhando perto.
Tom and Mary ate lunch together.	Tom e Maria almoçaram juntos.
Tom and Mary broke up last week.	Tom e Maria separaram-se na semana passada.
Tom and Mary don't want us here.	Tom e Mary não nos querem aqui.
Tom and Mary enjoyed that movie.	O Tom e a Mary gostaram desse filme.
Tom and Mary folded up the flag.	Tom e Maria dobraram a bandeira.
Tom and Mary got into their car.	Tom e Maria entraram no carro.
Tom and Mary had a pillow fight.	Tom e Mary fizeram uma guerra de travesseiros.
Tom and Mary had three children.	Tom e Maria tiveram três filhos.
Tom and Mary have been arrested.	Tom e Maria foram presos.
Tom and Mary have similar goals.	Tom e Maria têm objetivos semelhantes.
Tom and Mary have similar goals.	Tom e Maria têm objetivos parecidos.
Tom and Mary know what happened.	Tom e Mary sabem o que aconteceu.
Tom and Mary live in a bungalow.	Tom e Maria moram em um bangalô.
Tom and Mary met in high school.	Tom e Maria se conheceram no ensino médio.
Tom and Mary must work together.	Tom e Mary precisam trabalhar juntos.
Tom and Mary must work together.	Tom e Mary têm que trabalhar juntos.
Tom and Mary play golf together.	Tom e mary jogam golfe juntos.
Tom and Mary think I don't know.	Tom e Maria acham que eu não sei.
Tom and Mary took turns driving.	Tom e Mary revezaram a direção.
Tom and Mary used to be friends.	Tom e Maria eram amigos.
Tom and Mary want to talk to me.	Tom e Maria querem falar comigo.
Tom and Mary wanted to be alone.	Tom e Maria queriam ficar sozinhos.
Tom and Mary went out to dinner.	Tom e Maria foram jantar fora.
Tom and Mary were alone at home.	O Tom e a Mary estavam sozinhos em casa.
Tom and Mary were close friends.	O Tom e a Mary eram amigos próximos.
Tom and Mary were close friends.	Tom e Maria eram amigos próximos.
Tom and Mary were in the garden.	O Tom e a Mary estavam no jardim.
Tom and his wife adopted a girl.	Tom e sua esposa adotaram uma menina.
Tom appears to be a bit worried.	Tom parece estar um pouco preocupado.
Tom arrived a few minutes early.	Tom chegou alguns minutos mais cedo.
Tom arrived here three days ago.	Tom chegou aqui há três dias.
Tom arrived in Boston yesterday.	Tom chegou em Boston ontem.
Tom arrived in the nick of time.	Tom chegou na hora certa.
Tom arrived in the nick of time.	Tom chegou na hora h.
Tom arrived late at the station.	Tom chegou na estação atrasado.
Tom arrived three minutes early.	O Tom chegou três minutos adiantado.
Tom arrived three minutes early.	O Tom chegou três minutos antes.
Tom arrived three minutes early.	O Tom chegou três minutos mais cedo.
Tom asked Mary about her family.	O Tom perguntou à Mary sobre sua família.
Tom asked Mary if she knew John.	Tom perguntou a Mary se ela conhecia o John.
Tom asked Mary if she knew John.	O Tom perguntou à Mary se ela conhecia o John.
Tom asked Mary if she was happy.	Tom perguntou a Maria se ela estava feliz.
Tom asked Mary to open the door.	Tom pediu para Maria abrir a porta.
Tom asked Mary to open the door.	Tom pediu que Mary abrisse a porta.
Tom asked Mary where John lived.	Tom perguntou à Mary onde John morava.
Tom asked Mary why she was late.	O Tom perguntou à Mary por que ela estava atrasada.
Tom ate a piece of garlic bread.	Tom comeu um pedaço de pão de alho.
Tom ate two plates of spaghetti.	Tom comeu dois pratos de macarrão.
Tom believes that Mary is lying.	Tom acha que Mary está mentindo.
Tom bought Mary some chocolates.	Tom comprou chocolates para Mary.
Tom bought a ticket and went in.	Tom comprou o ingresso e entrou.
Tom bought drinks for everybody.	Tom comprou bebidas para todo mundo.
Tom bought three pairs of shoes.	Tom comprou três pares de sapatos.
Tom bought three pairs of socks.	Tom comprou três pares de meias.
Tom broke his leg in a ski race.	Tom quebrou a perna em uma corrida de esqui.
Tom broke the window on purpose.	Tom quebrou a janela de propósito.
Tom brought Mary back to Boston.	Tom trouxe Maria de volta para Boston.
Tom brought Mary to the station.	Tom levou a Mary até a estação.
Tom burned all of his old books.	Tom queimou todos os seus livros antigos.
Tom called the referee an idiot.	Tom chamou o árbitro de idiota.
Tom came at an inopportune time.	Tom veio num momento inoportuno.
Tom came back three hours later.	Tom voltou três horas depois.
Tom came to our house uninvited.	Tom veio à nossa casa sem ser convidado.
Tom can sing a few French songs.	Tom sabe cantar algumas músicas francesas.
Tom can sing a few French songs.	Tom sabe cantar algumas canções francesas.
Tom can't play tennis very well.	Tom não sabe jogar tênis muito bem.
Tom carefully took off his mask.	Tom cuidadosamente tirou a máscara.
Tom certainly looks intelligent.	O Tom, certamente, parece inteligente.
Tom certainly won't get my vote.	Certamente Tom não vai ganhar meu voto.
Tom changes his passwords often.	Tom altera a senha dele com frequência.
Tom changes his passwords often.	Tom altera sua senha com frequência.
Tom cheated on the geology exam.	Tom colou na prova de geologia.
Tom cheated on the history exam.	Tom colou na prova de história.
Tom cheated on the history exam.	Tom colou no teste de história.
Tom comes here almost every day.	Tom vem aqui quase todo dia.
Tom comes here almost every day.	Tom vem aqui quase todos os dias.
Tom comes here nearly every day.	Tom vem aqui quase todo dia.
Tom comes here nearly every day.	Tom vem aqui quase todos os dias.
Tom committed suicide last year.	Tom cometeu suicídio no ano passado.
Tom commutes to school by train.	Tom vai à escola de trem.
Tom completed the jigsaw puzzle.	Tom completou o quebra-cabeça.
Tom could hardly stand the pain.	Tom mal conseguia suportar a dor.
Tom couldn't look after himself.	Tom não poderia cuidar de si mesmo.
Tom covered Mary with a blanket.	Tom cobriu Maria com um cobertor.
Tom covered the car with a tarp.	O Tom cobriu o carro com uma lona.
Tom cut his finger with a knife.	Tom cortou o dedo com uma faca.
Tom decided to leave work early.	Tom decidiu sair mais cedo do trabalho.
Tom decided to take the day off.	Tom decidiu tirar o dia de folga.
Tom demanded to see the manager.	Tom exigiu ver o gerente.
Tom did better than we expected.	Tom foi melhor do que esperávamos.
Tom did his best, but he failed.	Tom fez o seu melhor, mas falhou.
Tom did his homework by himself.	Tom fez o seu trabalho de casa sozinho.
Tom did really well on the exam.	Tom foi muito bem na prova.
Tom did well on his French test.	Tom foi bem no seu teste de francês.
Tom did what I wanted him to do.	Tom fez o que eu estava esperando dele.
Tom didn't buy me what I needed.	Tom não comprou o que eu precisava.
Tom didn't die in the collision.	Tom não morreu na colisão.
Tom didn't do what he was asked.	Tom não fez o que lhe foi pedido.
Tom didn't even bother to reply.	O Tom nem se incomodou em responder.
Tom didn't explain it very well.	Tom não explicou muito bem.
Tom didn't follow Mary's advice.	Tom não seguiu o conselho de Mary.
Tom didn't have to go with Mary.	Tom não tinha que ir com Mary.
Tom didn't know Mary was hungry.	Tom não sabia que Maria estava com fome.
Tom didn't know what Mary meant.	Tom não sabia o que Mary queria dizer.
Tom didn't know you were joking.	Tom não sabia que você estava brincando.
Tom didn't like going to school.	Tom não gostava de ir à escola.
Tom didn't look happy to see me.	Tom não parecia feliz em me ver.
Tom didn't mean to hurt anybody.	Tom não queria machucar ninguém.
Tom didn't mean to hurt anybody.	Tom não tinha a intenção de machucar ninguém.
Tom didn't plan to go to Boston.	Tom não planejava ir a Boston.
Tom didn't recognize the number.	Tom não reconheceu o número.
Tom didn't say how much it cost.	Tom não disse quanto custou.
Tom didn't seem to be very busy.	Tom não parecia estar muito ocupado.
Tom didn't tell Mary everything.	Tom não contava tudo a Mary.
Tom didn't tell Mary everything.	Tom não contou tudo a Mary.
Tom didn't tell Mary to do that.	Tom não disse para Mary fazer isso.
Tom didn't tell the whole truth.	Tom não contou toda a verdade.
Tom didn't use to drink so much.	Tom não bebia tanto.
Tom didn't want to ask for help.	Tom não queria pedir ajuda.
Tom didn't want to be a fireman.	Tom não queria ser bombeiro.
Tom didn't want to be a teacher.	Tom não queria ser professor.
Tom didn't want to buy anything.	Tom não queria comprar nada.
Tom didn't want to go to school.	Tom não queria ir à escola.
Tom didn't want to learn French.	Tom não queria aprender francês.
Tom didn't want to study French.	Tom não queria estudar francês.
Tom didn't want to study abroad.	Tom não queria estudar no exterior.
Tom didn't want to study abroad.	Tom não queria estudar no estrangeiro.
Tom disappeared three weeks ago.	Tom desapareceu há três semanas.
Tom dislikes speaking in public.	O Tom não gosta de falar em público.
Tom does that, but Mary doesn't.	Tom faz isso, mas Mary não faz.
Tom does that, but Mary doesn't.	O Tom faz, mas a Mary não.
Tom doesn't care about anything.	Tom não se importa com nada.
Tom doesn't care what I'm doing.	O Tom não liga para o que eu estou fazendo.
Tom doesn't care, but Mary does.	Tom não se importa, mas Mary sim.
Tom doesn't come here very much.	Tom não vem aqui muito.
Tom doesn't come here very much.	Tom não vem muito aqui.
Tom doesn't do things like that.	O Tom não faz as coisas assim.
Tom doesn't eat as much as Mary.	Tom não come tanto quanto a Mary.
Tom doesn't even live in Boston.	Tom nem sequer mora em Boston.
Tom doesn't go to a good school.	Tom não vai para uma boa escola.
Tom doesn't go to school by bus.	Tom não vai para a escola de ônibus.
Tom doesn't have a bank account.	O Tom não tem uma conta no banco.
Tom doesn't have any bad habits.	Tom não tem maus hábitos.
Tom doesn't have much time left.	Tom não tem muito tempo restando.
Tom doesn't have to go in there.	Tom não precisa entrar lá.
Tom doesn't know Mary's address.	Tom não sabe o endereço de Maria.
Tom doesn't know much about art.	Tom não sabe muito sobre arte.
Tom doesn't know much about art.	Tom não conhece muita coisa de artes.
Tom doesn't know the half of it.	Tom não sabe nem a metade.
Tom doesn't know what'll happen.	Tom não sabe o que acontecerá.
Tom doesn't know where to begin.	Tom não sabe por onde começar.
Tom doesn't know where to start.	O Tom não sabe onde começar.
Tom doesn't know you have a car.	Tom não sabe que você tem um carro.
Tom doesn't like Mary very much.	Tom não gosta muito de Maria.
Tom doesn't like Mary's friends.	Tom não gosta dos amigos de Maria.
Tom doesn't like Mary's friends.	Tom não gosta das amigas de Maria.
Tom doesn't like eating popcorn.	Tom não gosta de comer pipoca.
Tom doesn't like his stepmother.	Tom não gosta da madrasta.
Tom doesn't like this very much.	Tom não gosta muito disso.
Tom doesn't like this very much.	Tom não gosta disso muito.
Tom doesn't live here in Boston.	Tom não mora aqui em Boston.
Tom doesn't often get depressed.	Tom não costuma ficar deprimido.
Tom doesn't take Mary seriously.	Tom não leva Maria a sério.
Tom doesn't think he'll do that.	Tom não acha que vai fazer isso.
Tom doesn't think it's possible.	Tom não acha que isso é possível.
Tom doesn't want to be a doctor.	Tom não quer ser médico.
Tom doesn't want to be a lawyer.	Tom não quer ser advogado.
Tom doesn't want to be a singer.	Tom não quer ser cantor.
Tom doesn't want to eat with us.	Tom não quer comer conosco.
Tom doesn't want to eat with us.	Tom não quer comer com a gente.
Tom doesn't want to get married.	Tom não quer se casar.
Tom doesn't want to go by train.	Tom não quer ir de trem.
Tom doesn't want to go swimming.	Tom não quer ir nadar.
Tom doesn't want to go to sleep.	Tom não quer ir dormir.
Tom doesn't want to go with you.	Tom não quer ir contigo.
Tom doesn't want to go with you.	Tom não quer ir com você.
Tom doesn't want to let Mary go.	Tom não quer deixar a Mary ir.
Tom doesn't want to say goodbye.	Tom não quer dizer adeus.
Tom doesn't want to say goodbye.	O Tom não quer dizer adeus.
Tom doesn't want to talk to you.	Tom não quer falar contigo.
Tom doesn't want to talk to you.	Tom não quer falar com você.
Tom doesn't want you doing that.	Tom não quer que você faça isso.
Tom doesn't want you to do that.	O Tom não quer que você faça isso.
Tom doubts Mary's story is true.	Tom duvida que a história de Mary seja verdade.
Tom drank three bottles of beer.	Tom bebeu três garrafas de cerveja.
Tom drank three glasses of wine.	Tom bebeu três taças de vinho.
Tom dried his hair with a towel.	Tom secou o cabelo com uma toalha.
Tom earns twice as much as I do.	Tom ganha o dobro que eu.
Tom earns twice as much as I do.	Tom ganha o dobro do que eu ganho.
Tom eats nothing but white meat.	Tom só come carne branca.
Tom expresses himself very well.	Tom se exprime muito bem.
Tom feels at home in the jungle.	Tom se sente em casa na floresta.
Tom filled his bucket with sand.	O Tom encheu o balde com areia.
Tom filled his glass with water.	Tom encheu de água seu copo.
Tom flosses his teeth every day.	Tom usa fio dental todos os dias.
Tom found a gun in Mary's purse.	Tom encontrou uma arma na bolsa de Maria.
Tom gave me a French dictionary.	Tom me deu um dicionário de francês.
Tom gave the money back to Mary.	Tom devolveu o dinheiro a Mary.
Tom gave the money back to Mary.	Tom pagou o que estava devendo a Mary.
Tom gave us permission to leave.	Tom nos deu permissão para sair.
Tom goes to church every Sunday.	Tom vai à igreja todos os domingos.
Tom got a hamster for Christmas.	Tom ganhou um hamster de Natal.
Tom got caught in a traffic jam.	O Tom ficou preso no engarrafamento.
Tom got married three weeks ago.	Tom se casou faz três semanas.
Tom got on the crowded elevator.	Tom entrou no elevador lotado.
Tom got up and went to the door.	Tom se levantou e foi até a porta.
Tom grew up in a one-horse town.	Tom cresceu em uma cidade insignificante.
Tom had a girlfriend named Mary.	Tom tinha uma namorada chamada Maria.
Tom had a girlfriend named Mary.	Tom teve uma namorada chamada Maria.
Tom had never lied to me before.	Tom nunca tinha mentido para mim antes.
Tom had never lied to me before.	Tom nunca mentira para mim antes.
Tom had never seen Mary so busy.	Tom nunca vira Maria tão ocupada.
Tom had never seen Mary so busy.	Tom nunca tinha visto Maria tão ocupada.
Tom had never seen Mary so busy.	Tom nunca havia visto Maria tão ocupada.
Tom had to wait for three hours.	Tom teve de esperar por três horas.
Tom handed Mary a cup of coffee.	Tom ofereceu a Mary uma xícara de café.
Tom handed the contract to Mary.	Tom entregou o contrato a Maria.
Tom handed the document to Mary.	Tom entregou o documento a Maria.
Tom hardly ever talks to anyone.	O Tom quase nunca fala com ninguém.
Tom has a good friend in Boston.	Tom tem um bom amigo em Boston.
Tom has a lot of original ideas.	Tom tem muitas ideias originais.
Tom has already moved to Boston.	Tom já se mudou para Boston.
Tom has always been a gentleman.	Tom sempre foi um cavalheiro.
Tom has always had that problem.	Tom sempre teve esse problema.
Tom has at least three children.	Tom tem no mínimo três filhos.
Tom has been lucky all his life.	Tom foi sortudo durante toda a vida.
Tom has been really busy lately.	Nesses últimos tempos,Tom esteve realmente ocupado.
Tom has decided to go to Boston.	Tom decidiu ir para Boston.
Tom has decided to go to Boston.	Tom decidiu ir a Boston.
Tom has decided to sell his car.	Tom decidiu vender o seu carro.
Tom has decided to sell his car.	Tom decidiu vender o carro dele.
Tom has fewer friends than I do.	Tom tem menos amigos que eu.
Tom has gone to the supermarket.	Tom foi ao supermercado.
Tom has granted me an interview.	Tom me concedeu uma entrevista.
Tom has lost his umbrella again.	Tom perdeu o seu guarda-chuva de novo.
Tom has lost his umbrella again.	Tom perdeu o guarda-chuva dele de novo.
Tom has more homework than I do.	Tom tem mais lição de casa do que eu.
Tom has never been very helpful.	Tom nunca foi muito útil.
Tom has never lied to me before.	Tom nunca mentiu para mim antes.
Tom has no interest in politics.	Tom não se interessa por política.
Tom has no political experience.	Tom não tem experiência política.
Tom has nothing to do with this.	Tom não tem nada a ver com isso.
Tom has promised to make amends.	Tom prometeu fazer reparos.
Tom has promised to make amends.	Tom prometeu dar uma satisfação.
Tom has put his car up for sale.	Tom colocou seu carro à venda.
Tom has serious health problems.	Tom tem sérios problemas de saúde.
Tom has some emotional problems.	Tom tem alguns problemas emocionais.
Tom has started writing a novel.	Tom começou a escrever um romance.
Tom has to fill out these forms.	Tom tem de preencher estes formulários.
Tom has to fill out these forms.	Tom tem que preencher estes formulários.
Tom has to speak French at work.	Tom tem de falar em francês no trabalho.
Tom has told me a lot about you.	O Tom já me falou muito sobre você.
Tom hasn't been very kind to us.	Tom não tem sido muito gentil conosco.
Tom hasn't grilled the fish yet.	O Tom não grelhou o peixe ainda.
Tom hasn't opened his store yet.	Tom ainda não abriu a sua loja.
Tom hasn't said anything either.	Tom também não disse nada.
Tom hasn't slept for three days.	Tom não dorme há três dias.
Tom heard Mary and John arguing.	Tom ouviu Maria e João discutindo.
Tom heard footsteps approaching.	O Tom ouviu passos se aproximando.
Tom helped Mary put her coat on.	Tom ajudou a Mary a vestir o casaco.
Tom hid himself behind the tree.	Tom escondeu-se atrás da árvore.
Tom hopes to see you in October.	Tom espera te ver em outubro.
Tom hung a calendar on the wall.	Tom pendurou um calendário na parede.
Tom ignored everyone's warnings.	Tom ignorou os avisos de todos.
Tom intends to become a teacher.	Tom pretende tornar-se professor.
Tom is Mary's biological father.	Tom é o pai biológico de Maria.
Tom is a bit strapped for money.	Tom é um pouco preso ao dinheiro.
Tom is a good teacher, isn't he?	Tom é um bom professor, não é?
Tom is a lot older than Mary is.	Tom é bem mais velho do que Maria.
Tom is a man who can be trusted.	O Tom é um homem em quem se pode confiar.
Tom is a primary school teacher.	Tom é professor de escola primária.
Tom is a really interesting guy.	Tom é um cara muito interessante.
Tom is a talented guitar player.	Tom é um guitarrista talentoso.
Tom is a troublemaker, isn't he?	Tom é encrenqueiro, não é?
Tom is a very dedicated student.	Tom é um estudante muito dedicado.
Tom is afraid of his own shadow.	Tom tem medo da própria sombra.
Tom is always reading something.	Tom está sempre lendo algo.
Tom is an expert on the subject.	Tom é um especialista sobre o assunto.
Tom is anxious about his future.	Tom está ansioso sobre seu futuro.
Tom is coming down the mountain.	Tom está descendo a montanha.
Tom is coming with us to Boston.	Tom está indo com a gente para Boston.
Tom is coming with us to Boston.	Tom está indo conosco para Boston.
Tom is deeply in love with Mary.	Tom está profundamente apaixonado por Mary.
Tom is doing a crossword puzzle.	Tom está fazendo palavras cruzadas.
Tom is from Australia, isn't he?	Tom está indo para a Austrália, não está?
Tom is from Australia, isn't he?	Tom está indo para a Austrália, não é?
Tom is from Australia, isn't he?	O Tom está indo para a Austrália, não está?
Tom is from Australia, isn't he?	O Tom está indo para a Austrália, não é?
Tom is getting a little nervous.	Tom está ficando um pouco nervoso.
Tom is getting married tomorrow.	Tom irá se casar amanhã.
Tom is getting married tomorrow.	Tom se casará amanhã.
Tom is going to be OK, isn't he?	Tom vai ficar bem, não vai?
Tom is going to be proud of you.	Tom ficará orgulhoso de você.
Tom is going to buy a new cello.	Tom vai comprar um violoncelo novo.
Tom is going to call the police.	Tom irá chamar a polícia.
Tom is going to cross the river.	Tom irá atravessar o rio.
Tom is going to do that for you.	Tom vai fazer isso por vocês.
Tom is going to do that for you.	Tom vai fazer isso por você.
Tom is going to do that for you.	Tom vai fazer isso para vocês.
Tom is going to do that for you.	Tom vai fazer isso para você.
Tom is going to do that for you.	O Tom vai fazer isso por vocês.
Tom is going to do that for you.	O Tom vai fazer isso por você.
Tom is going to do that for you.	O Tom vai fazer isso para vocês.
Tom is going to do that for you.	O Tom vai fazer isso para você.
Tom is going to go to Australia.	Tom está indo para a Austrália.
Tom is going to go to Australia.	O Tom está indo para a Austrália.
Tom is going to have to do that.	Tom vai ter que fazer isso.
Tom is going to like doing that.	Tom vai gostar de fazer isso.
Tom is going to like doing that.	O Tom vai gostar de fazer isso.
Tom is going to love this place.	Tom vai adorar este lugar.
Tom is going to miss doing that.	O Tom vai sentir saudade de fazer isso.
Tom is going to miss doing this.	O Tom vai sentir saudade de fazer isso.
Tom is going to propose to Mary.	Tom vai pedir a mão de Mary.
Tom is going to take care of me.	Tom vai tomar conta de mim.
Tom is going to tell us a story.	Tom irá nos contar uma história.
Tom is going to want to do that.	Tom vai querer fazer isso.
Tom is going to want to do that.	O Tom vai querer fazer isso.
Tom is hiding a terrible secret.	Tom está escondendo um terrível segredo.
Tom is holding a bottle of beer.	Tom está segurando uma garrafa de cerveja.
Tom is just trying to scare you.	Tom só está tentando te assustar.
Tom is looking for his car keys.	Tom está procurando a chave do carro dele.
Tom is looking for his car keys.	Tom está procurando a chave de seu carro.
Tom is looking into the problem.	Tom está investigando o problema.
Tom is looking into the problem.	Tom está examinando o problema.
Tom is lying in bed with a cold.	O Tom está deitado na cama com resfriado.
Tom is much older than he looks.	Tom é muito mais velho do que parece.
Tom is no longer working for us.	Tom não trabalha mais para nós.
Tom is often absent from school.	Tom falta muito à escola.
Tom is older than Mary's father.	Tom é mais velho que o pai de Maria.
Tom is on vacation in Australia.	Tom está de férias na Austrália.
Tom is one of my best customers.	Tom é um dos meus melhores clientes.
Tom is one of our top engineers.	Tom é um dos nossos melhores engenheiros.
Tom is out, but Mary is at home.	Tom saiu, mas Maria está em casa.
Tom is perfect for me, isn't he?	O Tom é perfeito para mim, não é?
Tom is picky about what he eats.	Tom não come qualquer coisa.
Tom is playing tennis with Mary.	Tom está jogando tênis com Maria.
Tom is quite handsome, isn't he?	Tom é muito bonito, não é?
Tom is quite sociable, isn't he?	Tom é bastante sociável, não é?
Tom is quite stubborn, isn't he?	Tom é bastante teimoso, não é?
Tom is really popular, isn't he?	Tom é mesmo popular, né?
Tom is really serious, isn't he?	Tom é mesmo sério, não é?
Tom is singing a beautiful song.	Tom está cantando uma bela canção.
Tom is smarter than Mary thinks.	Tom é mais inteligente do que Maria pensa.
Tom is someone I really respect.	O Tom é alguém que eu realmente respeito.
Tom is still in there somewhere.	Tom ainda está em algum lugar lá dentro.
Tom is still too young to drive.	Tom ainda é muito jovem para dirigir.
Tom is the best at what he does.	Tom é o melhor no que ele faz.
Tom is the best coach in Boston.	Tom é o melhor técnico de Boston.
Tom is the frontman of the band.	Tom é o vocalista da banda.
Tom is the only Canadian I know.	Tom é o único canadense que eu conheço.
Tom is too young to be the boss.	Tom é jovem demais para ser o chefe.
Tom is too young to drive a car.	Tom é muito novo para dirigir um carro.
Tom is too young to drive a car.	Tom é muito jovem para dirigir um carro.
Tom is too young to get married.	Tom é jovem demais para se casar.
Tom is trying to calm Mary down.	Tom está tentando acalmar Mary.
Tom is very concerned about you.	Tom está muito preocupado com você.
Tom is very dedicated, isn't he?	Tom é muito dedicado, não é?
Tom is very impatient, isn't he?	Tom é muito impaciente, não é?
Tom is very observant, isn't he?	Tom é muito observador, não é?
Tom is waiting by the elevators.	Tom está esperando junto aos elevadores.
Tom is wearing a Halloween mask.	Tom está usando uma máscara de Dia das Bruxas.
Tom is wearing a leather jacket.	Tom está usando uma jaqueta de couro.
Tom is working on another novel.	Tom está trabalhando em outro romance.
Tom is worried about his future.	Tom está preocupado sobre seu futuro.
Tom is writing a letter to Mary.	Tom está escrevendo uma carta a Maria.
Tom is your boyfriend, isn't he?	Tom é seu namorado, não é?
Tom isn't a high school student.	Tom não é um estudante do ensino médio.
Tom isn't all that conservative.	Tom não é tão conservador.
Tom isn't doing a very good job.	Tom não está fazendo um bom trabalho.
Tom isn't going to buy anything.	Tom não vai comprar nada.
Tom isn't going with you, is he?	O Tom não vai com vocês, não é?
Tom isn't going with you, is he?	O Tom não vai com você, não é?
Tom isn't trying to do anything.	Tom não está tentando fazer nada.
Tom isn't your boyfriend, is he?	Tom não é seu namorado, é?
Tom joined the high school band.	Tom se juntou na banda da escola.
Tom joined the high school band.	Tom entrou para a banda do ensino médio.
Tom just wants to be left alone.	Tom só quer ser deixado em paz.
Tom just wants to be left alone.	Tom só quer ser deixado a sós.
Tom kissed Mary on her forehead.	Tom beijou Maria na testa.
Tom kissed Mary on the forehead.	O Tom beijou a Mary na testa.
Tom knew Mary couldn't eat nuts.	Tom sabia que Maria não podia comer nozes.
Tom knew Mary would arrive late.	Tom sabia que Mary se atrasaria.
Tom knew that Mary was innocent.	Tom sabia que Maria era inocente.
Tom knew what Mary's secret was.	Tom sabia qual era o segredo de Mary.
Tom knew what needed to be done.	Tom sabia o que precisava ser feito.
Tom knows Mary better than I do.	Tom conhece Mary melhor do que eu.
Tom knows exactly what happened.	Tom sabe exatamente o que aconteceu.
Tom knows he's better than Mary.	Tom sabe que é melhor do que Mary.
Tom knows he's not going to win.	Tom sabe que não vai vencer.
Tom knows how to comfort people.	Tom sabe como consolar as pessoas.
Tom knows how to comfort people.	Tom sabe como confortar as pessoas.
Tom knows how to cook spaghetti.	Tom sabe fazer espaguete.
Tom knows how to handle himself.	Tom sabe lidar consigo mesmo.
Tom knows that I don't like him.	Tom sabe que não gosto dele.
Tom knows that Mary is bluffing.	Tom sabe que Maria está blefando.
Tom knows what Mary wants to do.	Tom sabe o que Mary quer fazer.
Tom knows what he's going to do.	Tom sabe o que vai fazer.
Tom knows what needs to be done.	Tom sabe o que precisa ser feito.
Tom knows where Mary is staying.	Tom sabe onde Maria está hospedada.
Tom laughed when Mary said that.	Tom riu quando Mary disse aquilo.
Tom learned French very quickly.	Tom aprendeu francês muito rápido.
Tom left at four in the morning.	Tom saiu às quatro da manhã.
Tom left his umbrella in my car.	Tom deixou o guarda-chuva dele no meu carro.
Tom left his umbrella in my car.	Tom deixou o seu guarda-chuva no meu carro.
Tom left some food on his plate.	Tom deixou um pouco de comida em seu prato.
Tom left some food on his plate.	Tom deixou comida no prato.
Tom left without saying goodbye.	Tom foi embora sem dizer tchau.
Tom left without telling anyone.	Tom saiu sem falar com ninguém.
Tom lent me this book last week.	Tom emprestou-me este livro na semana passada.
Tom lent thirty dollars to Mary.	Tom emprestou trinta dólares a Maria.
Tom likes dogs better than cats.	Tom gosta mais de cachorros do que de gatos.
Tom likes singing in the shower.	Tom gosta de cantar no chuveiro.
Tom likes talking about himself.	Tom gosta de falar sobre si mesmo.
Tom likes to avoid large crowds.	Tom gosta de evitar grandes multidões.
Tom likes to listen to podcasts.	Tom gosta de ouvir podcasts.
Tom likes to play with his dogs.	Tom gosta de brincar com seus cachorros.
Tom likes to sing in the shower.	Tom gosta de cantar no chuveiro.
Tom likes to stay at home alone.	Tom gosta de ficar sozinho em casa.
Tom likes to talk about himself.	Tom gosta de falar sobre si mesmo.
Tom lives alone in an apartment.	Tom mora sozinho em um apartamento.
Tom lives in a bad neighborhood.	Tom mora em um bairro ruim.
Tom lives in a bad part of town.	Tom mora numa parte ruim da cidade.
Tom lives in a very big mansion.	Tom mora numa mansão enorme.
Tom looked at Mary and shrugged.	Tom olhou para Maria e deu de ombros.
Tom looked at the message again.	Tom olhou a mensagem de novo.
Tom looked into the living room.	Tom olhou na sala.
Tom looked like he always looks.	Tom olhou como sempre olha.
Tom looks a lot like his father.	Tom se parece muito com o pai.
Tom looks a lot older than Mary.	Tom parece ser muito mais velho do que Maria.
Tom loves Mary's sense of humor.	Tom adora o senso de humor de Maria.
Tom loves to sing in the shower.	Tom adora cantar no chuveiro.
Tom made an important discovery.	Tom fez uma importante descoberta.
Tom made friends with everybody.	Tom fez amizade com todo mundo.
Tom made friends with everybody.	Tom fez amizade com todos.
Tom managed to put out the fire.	Tom conseguiu apagar o fogo.
Tom may eat as much as he wants.	Tom pode comer o tanto que quiser.
Tom mentioned Mary's name twice.	Tom mencionou o nome de Maria duas vezes.
Tom needs time to think it over.	Tom precisa de tempo para pensar.
Tom needs to buy a new raincoat.	Tom precisa comprar uma capa de chuva nova.
Tom needs to improve his grades.	Tom precisa melhorar as suas notas.
Tom needs to know where Mary is.	Tom precisa saber onde Mary está.
Tom needs to sign this document.	Tom precisa assinar este documento.
Tom needs to update his website.	Tom precisa atualizar o seu site.
Tom never said he would help us.	Tom nunca disse que iria nos ajudar.
Tom noticed blood on the carpet.	O Tom notou que havia sangue no tapete.
Tom only speaks a little French.	Tom só fala um pouco de francês.
Tom only wears designer clothes.	Tom só usa roupas de grife.
Tom opened the trunk of the car.	Tom abriu o porta-malas do carro.
Tom owns a house with two rooms.	Tom tem uma casa de dois cômodos.
Tom picked us up at the airport.	Tom nos buscou no aeroporto.
Tom played with his toy tractor.	Tom brincou com seu trator de brinquedo.
Tom poked the fire with a stick.	Tom cutucou o fogo com um graveto.
Tom poured tea for his visitors.	Tom serviu chá aos visitantes.
Tom poured water into the basin.	Tom derramou água na pia.
Tom pretended he was my brother.	Tom fingiu ser meu irmão.
Tom pretended not to understand.	Tom fingia não entender.
Tom probably has food poisoning.	Tom provavelmente está com intoxicação alimentar.
Tom probably thought I was busy.	Tom provavelmente pensou que eu estava ocupado.
Tom promised me he wouldn't cry.	Tom me prometeu que não iria chorar.
Tom promised to take me fishing.	O Tom prometeu me levar para pescar.
Tom pushed Mary down the stairs.	Tom empurrou Maria escada abaixo.
Tom pushed Mary out of the room.	Tom empurrou Maria para fora da sala.
Tom pushed the emergency button.	Tom apertou o botão de emergência.
Tom put a bandage on Mary's arm.	Tom colocou um curativo no braço de Maria.
Tom put his bag under the table.	Tom colocou a bolsa embaixo da mesa.
Tom put his books in his locker.	Tom pôs seus livros em seu armário.
Tom put his hand over his mouth.	Tom colocou a mão sobre a boca.
Tom put his phone in his pocket.	Tom colocou seu telefone no bolso.
Tom put his shirt on inside out.	Tom colocou a camisa do avesso.
Tom put his shirt on inside out.	Tom colocou a camisa pelo avesso.
Tom put on his shirt inside out.	Tom colocou a camisa do avesso.
Tom put on his shirt inside out.	Tom colocou a camisa pelo avesso.
Tom put on one of John's shirts.	Tom vestiu uma das camisas de John.
Tom put the chicken in the oven.	Tom pôs o frango no forno.
Tom put the kettle on the stove.	Tom colocou a chaleira no fogão.
Tom put the key into his pocket.	Tom colocou a chave no bolso.
Tom put the mop behind the door.	Tom colocou o esfregão atrás da porta.
Tom ran to catch the last train.	Tom correu para pegar o último trem.
Tom read the message and smiled.	Tom leu a mensagem e sorriu.
Tom read thirty books last year.	O Tom leu trinta livros no ano passado.
Tom readily admits his mistakes.	Tom admite seus erros imediatamente.
Tom really likes chocolate cake.	Tom gosta muito de bolo de chocolate.
Tom received a letter from Mary.	Tom recebeu uma carta de Maria.
Tom recommended this book to me.	Tom recomendou este livro para mim.
Tom remained silent for a while.	Tom fez silêncio um instante.
Tom retired on October 20, 2013.	Tom aposentou-se em 20 de outubro de 2013.
Tom returned to the living room.	Tom voltou à sala de estar.
Tom roasts his own coffee beans.	Tom torra seu próprios grãos de café.
Tom rolled up his shirt sleeves.	Tom arregaçou as mangas da camisa.
Tom said Boston is a nice place.	Tom disse que Boston é um lugar legal.
Tom said Mary was a nice person.	Tom disse que Mary era uma pessoa legal.
Tom said he didn't drink coffee.	Tom disse que não bebeu café.
Tom said he enjoyed the concert.	Tom diz ter gostado do show.
Tom said he was extremely tired.	Tom disse que estava extremamente cansado.
Tom said he was going to Boston.	Tom disse que estava indo para Boston.
Tom said he was looking for you.	Tom disse que estava te procurando.
Tom said he was tired of losing.	Tom disse que estava cansado de perder.
Tom said he would come tomorrow.	Tom disse que viria amanhã.
Tom said he'd give me a massage.	Tom disse que ia me dar uma massagem.
Tom said he'll do that for Mary.	Tom disse que vai fazer isso pela Mary.
Tom said that Mary was homesick.	Tom disse que Mary estava com saudade de casa.
Tom said that he was in a hurry.	Tom disse que estava com pressa.
Tom said that he'd go to Boston.	Tom disse que iria para Boston.
Tom said you were almost killed.	Tom disse que você quase foi morto.
Tom said you'd do that for Mary.	Tom disse que você faria isso pela Mary.
Tom sat down on a folding chair.	Tom sentou-se em uma cadeira dobrável.
Tom sat down on a folding chair.	Tom sentou-se numa cadeira dobrável.
Tom sat on the arm of the couch.	Tom sentou no braço do sofá.
Tom sat silently for 30 minutes.	Tom sentou-se silenciosamente por 30 minutos.
Tom saved three hundred dollars.	O Tom economizou trezentos dólares.
Tom saw Mary coming towards him.	Tom viu Maria aproximando-se dele.
Tom saw Mary coming towards him.	Tom via a Mary se aproximando dele.
Tom saw something on the ground.	Tom viu algo no chão.
Tom says he doesn't like Boston.	Tom diz que ele não gosta de Boston.
Tom says he has nothing to hide.	Tom diz que não tem nada que esconder.
Tom says he'll do that for Mary.	Tom diz que vai fazer isso pela Mary.
Tom says that he'll wait for us.	Tom diz que vai esperar pela gente.
Tom says that he'll wait for us.	Tom diz que vai esperar por nós.
Tom seemed to be in a big hurry.	Tom parecia estar com muita pressa.
Tom seems to be very happy here.	Tom parece ficar muito feliz aqui.
Tom seems to have caught a cold.	Tom parece ter pegado um resfriado.
Tom seems to like Japanese food.	Tom parece gostar de comida japonesa.
Tom seldom does that by himself.	Tom raramente faz isso sozinho.
Tom set the basket on the table.	Tom pôs a cesta em cima da mesa.
Tom set the basket on the table.	Tom pôs a cesta sobre a mesa.
Tom shared his sandwich with me.	Tom dividiu o sanduíche dele comigo.
Tom shot at the deer but missed.	Tom atirou no cervo mas não o acertou.
Tom should be fired immediately.	Tom deve ser demitido imediatamente.
Tom should probably go home now.	Tom provavelmente deve ir para casa agora.
Tom should've called the police.	Tom deveria ter chamado a polícia.
Tom shouldn't have married Mary.	Tom não deveria ter se casado com Maria.
Tom shouldn't have trusted Mary.	Tom não deveria ter confiado em Maria.
Tom shouldn't have written that.	Tom não deveria ter escrito aquilo.
Tom shouted something in French.	Tom gritou algo em francês.
Tom showed Mary a photo of John.	Tom mostrou a Maria uma foto de João.
Tom showed the pictures to Mary.	Tom mostrou as fotos a Mary.
Tom slammed the door in my face.	Tom bateu a porta na minha cara.
Tom sleeps with his window open.	Tom dorme com a janela aberta.
Tom slept like a log last night.	Tom dormiu como uma pedra na noite passada.
Tom sold his house for $300,000.	Tom vendeu sua casa por 300,000 dólares.
Tom sold his house for $300,000.	Tom vendeu a casa dele por 300,000 dólares.
Tom sold his motorcycle to Mary.	Tom vendeu sua moto a Mary.
Tom speaks French like a native.	Tom fala francês como um nativo.
Tom speaks with a French accent.	Tom fala com um sotaque francês.
Tom spent three years in prison.	O Tom passou três anos na prisão.
Tom stabbed Mary thirteen times.	Tom apunhalou Maria treze vezes.
Tom stared at Mary with disgust.	Tom encarou Mary com nojo.
Tom started banging on the door.	Tom começou a bater na porta.
Tom started banging on the door.	O Tom começou a bater na porta.
Tom started scrubbing the floor.	Tom começou esfregando o chão.
Tom stayed at his uncle's house.	Tom ficou na casa de seu tio.
Tom stayed at his uncle's house.	Tom ficou na casa do tio dele.
Tom stayed in the house all day.	Tom ficou o dia inteiro em casa.
Tom still hasn't washed the car.	Tom ainda não lavou o carro.
Tom still isn't sure what to do.	Tom ainda não tem certeza do que fazer.
Tom still thinks Mary likes him.	Tom ainda pensa que Maria gosta dele.
Tom stole his dad's credit card.	Tom roubou o cartão de crédito de seu pai.
Tom straightened up his bedroom.	O Tom arrumou o quarto dele.
Tom suffers from claustrophobia.	Tom tem claustrofobia.
Tom suggested that we wait here.	Tom sugeriu que aguardássemos aqui.
Tom suggested that we wait here.	Tom sugeriu que esperássemos aqui.
Tom swims better than Mary does.	Tom nada melhor que Mary.
Tom swims better than Mary does.	Tom nada melhor do que Mary.
Tom takes himself too seriously.	Tom se leva demasiadamente a sério.
Tom thinks Mary is a bit chubby.	Tom acha que Maria está um pouco gordinha.
Tom thought he was going to die.	Tom pensou que ia morrer.
Tom thought that Mary loved him.	Tom achava que Maria o amava.
Tom threw the ball back to Mary.	Tom jogou a bola de volta para Mary.
Tom told Mary about his new car.	Tom contou a Maria sobre o seu novo carro.
Tom told Mary he wasn't married.	Tom disse a Maria que não era casado.
Tom told Mary she was beautiful.	Tom disse a Maria que ela era bonita.
Tom told Mary that John was shy.	Tom disse a Mary que John era tímido.
Tom told Mary that he was happy.	Tom disse a Mary que estava feliz.
Tom told Mary that he was ready.	Tom disse para a Mary que ele estava pronto.
Tom told Mary that he was ready.	Tom disse para a Mary que estava pronto.
Tom told Mary what had happened.	O Tom contou para a Mary o que tinha acontecido.
Tom told me he tried to do that.	Tom me disse que tentou fazer isso.
Tom told me he wants to do that.	Tom me disse que quer fazer isso.
Tom took a taxi to the hospital.	Tom pegou um táxi para o hospital.
Tom took his brother to the zoo.	Tom levou o seu irmão ao zoológico.
Tom took his brother to the zoo.	Tom levou o irmão dele ao zoológico.
Tom took the children to school.	Tom levou as crianças para a escola.
Tom took the dog out for a walk.	Tom levou o cachorro para passear.
Tom took the kids to the school.	Tom levou as crianças para a escola.
Tom travels less than Mary does.	Tom viaja menos do que Maria.
Tom tried doing that by himself.	Tom tentou fazer isso sozinho.
Tom tried to change the subject.	Tom tentou mudar de assunto.
Tom tried to ignore the problem.	Tom tentou ignorar o problema.
Tom tried to regain his balance.	Tom tentou recuperar o equilíbrio.
Tom tuned Mary's guitar for her.	Tom afinou a guitarra de Maria para ela.
Tom types better than Mary does.	Tom digita melhor do que Maria.
Tom uploaded a video on YouTube.	Tom enviou um vídeo ao YouTube.
Tom volunteered for the mission.	O Tom se ofereceu como voluntário para a missão.
Tom waited for Mary to continue.	Tom esperou que Mary continuasse.
Tom wanted Mary to learn French.	Tom queria que a Mary aprendesse francês.
Tom wanted Mary to study French.	Tom queria que Maria estudasse francês.
Tom wanted Mary to study harder.	Tom queria que Maria estudasse mais.
Tom wanted Mary to talk to John.	Tom queria que Maria falasse com João.
Tom wanted to become a diplomat.	Tom queria ser diplomata.
Tom wanted to buy a cheaper car.	Tom queria comprar um carro mais barato.
Tom wanted to go back to Boston.	Tom queria voltar para Boston.
Tom wanted to hear every detail.	Tom queria ouvir todos os detalhes.
Tom wanted to learn how to read.	Tom queria aprender a ler.
Tom wanted to learn how to swim.	Tom queria aprender a nadar.
Tom wants a pair of black shoes.	Tom quer um par de sapatos pretos.
Tom wants me to do that for him.	Tom quer que eu faça isso por ele.
Tom wants me to do that for him.	Tom quer que eu faça isso para ele.
Tom wants to be a tattoo artist.	Tom quer ser tatuador.